Date,Generation,Shipped,RMA,CIF,Activated,Not Activated,Online,Blinking,Offline
2020-08-01,PVT,160,53,107,84,23,33,0,51
2020-08-01,PVT2,239,53,186,162,24,93,4,65
2020-08-01,MP1,377,57,320,277,43,209,7,61
2020-08-01,MP1m,53,4,49,44,5,34,0,10
2020-08-01,MP2,756,71,685,644,41,567,18,59
2020-08-01,MP3,703,68,635,584,51,505,21,58
2020-08-01,MP4,529,10,519,346,173,259,52,35
2020-08-01,MP5,0,1,0,0,0,0,0,0
2020-08-02,PVT,160,53,107,84,23,33,0,51
2020-08-02,PVT2,239,53,186,162,24,92,4,66
2020-08-02,MP1,377,57,320,277,43,206,8,63
2020-08-02,MP1m,53,4,49,44,5,34,0,10
2020-08-02,MP2,756,71,685,644,41,568,17,59
2020-08-02,MP3,703,68,635,585,50,505,21,59
2020-08-02,MP4,529,10,519,366,153,266,55,45
2020-08-02,MP5,0,1,0,0,0,0,0,0
2020-08-03,PVT,160,53,107,84,23,32,0,52
2020-08-03,PVT2,239,53,186,162,24,92,5,65
2020-08-03,MP1,377,58,319,276,43,207,8,61
2020-08-03,MP1m,53,4,49,44,5,34,0,10
2020-08-03,MP2,756,71,685,644,41,571,13,60
2020-08-03,MP3,703,69,634,584,50,502,24,58
2020-08-03,MP4,529,12,517,376,141,281,55,40
2020-08-03,MP5,0,1,0,0,0,0,0,0
2020-08-04,PVT,160,53,107,84,23,32,0,52
2020-08-04,PVT2,239,53,186,162,24,90,5,67
2020-08-04,MP1,377,58,319,276,43,207,7,62
2020-08-04,MP1m,53,4,49,44,5,34,0,10
2020-08-04,MP2,756,71,685,644,41,571,14,59
2020-08-04,MP3,703,69,634,584,50,501,26,57
2020-08-04,MP4,554,12,542,382,160,283,65,34
2020-08-04,MP5,0,1,0,0,0,0,0,0
2020-08-05,PVT,160,53,107,84,23,31,1,52
2020-08-05,PVT2,239,53,186,162,24,89,5,68
2020-08-05,MP1,377,59,318,275,43,205,8,62
2020-08-05,MP1m,53,4,49,44,5,34,0,10
2020-08-05,MP2,756,71,685,644,41,570,12,62
2020-08-05,MP3,703,69,634,586,48,498,30,58
2020-08-05,MP4,554,12,542,386,156,289,65,32
2020-08-05,MP5,0,1,0,0,0,0,0,0
2020-08-06,PVT,160,53,107,84,23,29,1,54
2020-08-06,PVT2,239,53,186,162,24,88,6,68
2020-08-06,MP1,377,59,318,275,43,206,7,62
2020-08-06,MP1m,53,4,49,44,5,34,0,10
2020-08-06,MP2,756,72,684,643,41,568,11,64
2020-08-06,MP3,703,72,631,583,48,500,28,55
2020-08-06,MP4,562,12,550,389,161,294,63,32
2020-08-06,MP5,0,1,0,0,0,0,0,0
2020-08-07,PVT,160,53,107,84,23,29,1,54
2020-08-07,PVT2,239,53,186,162,24,88,5,69
2020-08-07,MP1,377,59,318,275,43,205,8,62
2020-08-07,MP1m,53,4,49,45,4,34,0,11
2020-08-07,MP2,756,73,683,643,40,571,6,66
2020-08-07,MP3,703,73,630,584,46,496,31,57
2020-08-07,MP4,562,12,550,393,157,306,53,34
2020-08-07,MP5,0,1,0,0,0,0,0,0
2020-08-08,PVT,160,53,107,84,23,29,1,54
2020-08-08,PVT2,239,53,186,162,24,89,5,68
2020-08-08,MP1,377,59,318,275,43,207,5,63
2020-08-08,MP1m,53,4,49,45,4,34,1,10
2020-08-08,MP2,756,73,683,643,40,569,9,65
2020-08-08,MP3,703,73,630,585,45,498,28,59
2020-08-08,MP4,595,12,583,411,172,321,44,46
2020-08-08,MP5,0,1,0,0,0,0,0,0
2020-08-09,PVT,160,53,107,84,23,29,1,54
2020-08-09,PVT2,239,53,186,162,24,89,5,68
2020-08-09,MP1,377,59,318,275,43,204,5,66
2020-08-09,MP1m,53,4,49,45,4,34,1,10
2020-08-09,MP2,756,73,683,643,40,565,12,66
2020-08-09,MP3,703,73,630,586,44,493,32,61
2020-08-09,MP4,595,12,583,435,148,328,51,56
2020-08-09,MP5,0,1,0,0,0,0,0,0
2020-08-10,PVT,160,53,107,84,23,29,1,54
2020-08-10,PVT2,239,53,186,162,24,85,8,69
2020-08-10,MP1,377,59,318,275,43,206,3,66
2020-08-10,MP1m,53,4,49,45,4,35,1,9
2020-08-10,MP2,756,75,681,643,38,564,9,70
2020-08-10,MP3,703,74,629,586,43,487,39,60
2020-08-10,MP4,595,14,581,449,132,334,65,50
2020-08-10,MP5,0,1,0,0,0,0,0,0
2020-08-11,PVT,160,53,107,84,23,29,1,54
2020-08-11,PVT2,239,53,186,162,24,88,5,69
2020-08-11,MP1,377,59,318,275,43,205,4,66
2020-08-11,MP1m,53,4,49,45,4,35,1,9
2020-08-11,MP2,756,75,681,643,38,561,12,70
2020-08-11,MP3,703,74,629,586,43,485,39,62
2020-08-11,MP4,622,14,608,468,140,337,71,60
2020-08-11,MP5,0,1,0,0,0,0,0,0
2020-08-12,PVT,160,53,107,84,23,30,0,54
2020-08-12,PVT2,239,53,186,162,24,88,5,69
2020-08-12,MP1,377,59,318,275,43,206,3,66
2020-08-12,MP1m,53,4,49,45,4,35,1,9
2020-08-12,MP2,756,75,681,643,38,559,14,70
2020-08-12,MP3,703,74,629,586,43,482,40,64
2020-08-12,MP4,629,14,615,475,140,336,84,55
2020-08-12,MP5,2,1,2,0,2,0,0,0
2020-08-13,PVT,160,53,107,84,23,30,0,54
2020-08-13,PVT2,239,54,185,161,24,87,4,70
2020-08-13,MP1,377,60,317,274,43,206,3,65
2020-08-13,MP1m,53,4,49,45,4,36,0,9
2020-08-13,MP2,756,75,681,644,37,558,14,72
2020-08-13,MP3,703,76,627,584,43,483,39,62
2020-08-13,MP4,642,17,625,480,145,339,95,46
2020-08-13,MP5,2,1,2,0,2,0,0,0
2020-08-14,PVT,160,53,107,84,23,29,1,54
2020-08-14,PVT2,239,54,185,161,24,84,4,73
2020-08-14,MP1,377,60,317,274,43,205,4,65
2020-08-14,MP1m,53,4,49,45,4,37,0,8
2020-08-14,MP2,756,76,680,643,37,554,16,73
2020-08-14,MP3,703,76,627,585,42,485,41,59
2020-08-14,MP4,642,19,623,483,140,351,87,45
2020-08-14,MP5,12,1,12,0,12,0,0,0
2020-08-15,PVT,160,53,107,84,23,29,1,54
2020-08-15,PVT2,239,54,185,161,24,83,2,76
2020-08-15,MP1,377,60,317,274,43,205,4,65
2020-08-15,MP1m,53,4,49,45,4,36,0,9
2020-08-15,MP2,756,76,680,643,37,554,17,72
2020-08-15,MP3,703,76,627,585,42,486,37,62
2020-08-15,MP4,642,19,623,489,134,366,78,45
2020-08-15,MP5,23,1,23,0,23,0,0,0
2020-08-16,PVT,160,53,107,84,23,29,2,53
2020-08-16,PVT2,239,54,185,161,24,82,2,77
2020-08-16,MP1,377,60,317,274,43,207,2,65
2020-08-16,MP1m,53,4,49,45,4,36,0,9
2020-08-16,MP2,756,76,680,643,37,554,16,73
2020-08-16,MP3,703,76,627,586,41,485,38,63
2020-08-16,MP4,642,19,623,504,119,375,74,55
2020-08-16,MP5,23,1,23,1,22,0,0,1
2020-08-17,PVT,160,53,107,84,23,29,2,53
2020-08-17,PVT2,239,55,184,160,24,80,5,75
2020-08-17,MP1,377,60,317,274,43,207,2,65
2020-08-17,MP1m,53,4,49,45,4,36,0,9
2020-08-17,MP2,756,77,679,642,37,554,18,70
2020-08-17,MP3,703,77,626,586,40,493,27,66
2020-08-17,MP4,642,23,619,507,112,389,69,49
2020-08-17,MP5,23,1,23,4,19,0,1,3
2020-08-18,PVT,160,53,107,84,23,29,2,53
2020-08-18,PVT2,239,55,184,160,24,80,8,72
2020-08-18,MP1,377,60,317,275,42,206,3,66
2020-08-18,MP1m,53,4,49,45,4,35,1,9
2020-08-18,MP2,756,77,679,642,37,554,17,71
2020-08-18,MP3,703,77,626,588,38,495,25,68
2020-08-18,MP4,642,25,617,510,107,400,66,44
2020-08-18,MP5,23,1,23,6,17,0,4,2
2020-08-19,PVT,160,53,107,84,23,28,1,55
2020-08-19,PVT2,239,55,184,160,24,82,7,71
2020-08-19,MP1,377,62,315,273,42,202,5,66
2020-08-19,MP1m,53,4,49,45,4,35,1,9
2020-08-19,MP2,756,77,679,642,37,553,16,73
2020-08-19,MP3,703,78,625,588,37,497,25,66
2020-08-19,MP4,642,26,616,519,97,413,55,51
2020-08-19,MP5,23,1,23,8,15,0,6,2
2020-08-20,PVT,160,53,107,84,23,28,1,55
2020-08-20,PVT2,239,55,184,160,24,83,6,71
2020-08-20,MP1,377,62,315,274,41,201,5,68
2020-08-20,MP1m,53,4,49,45,4,35,1,9
2020-08-20,MP2,756,77,679,642,37,550,17,75
2020-08-20,MP3,703,78,625,588,37,493,31,64
2020-08-20,MP4,642,26,616,526,90,416,58,52
2020-08-20,MP5,23,1,23,9,14,0,7,2
2020-08-21,PVT,160,53,107,85,22,29,1,55
2020-08-21,PVT2,239,56,183,159,24,83,5,71
2020-08-21,MP1,377,62,315,274,41,200,5,69
2020-08-21,MP1m,53,4,49,45,4,35,1,9
2020-08-21,MP2,756,79,677,640,37,551,16,73
2020-08-21,MP3,703,80,623,587,36,495,29,63
2020-08-21,MP4,642,31,611,525,86,426,57,42
2020-08-21,MP5,23,1,23,12,11,0,9,3
2020-08-22,PVT,160,53,107,85,22,28,1,56
2020-08-22,PVT2,239,56,183,159,24,82,5,72
2020-08-22,MP1,377,62,315,274,41,198,5,71
2020-08-22,MP1m,53,4,49,45,4,35,1,9
2020-08-22,MP2,756,79,677,640,37,557,8,75
2020-08-22,MP3,703,80,623,587,36,493,28,66
2020-08-22,MP4,642,31,611,527,84,441,46,40
2020-08-22,MP5,23,1,23,13,10,0,11,2
2020-08-23,PVT,160,53,107,85,22,27,2,56
2020-08-23,PVT2,239,56,183,159,24,84,2,73
2020-08-23,MP1,377,62,315,274,41,198,6,70
2020-08-23,MP1m,53,4,49,45,4,35,0,10
2020-08-23,MP2,756,79,677,640,37,552,8,80
2020-08-23,MP3,703,80,623,587,36,490,28,69
2020-08-23,MP4,642,31,611,532,79,445,41,46
2020-08-23,MP5,23,1,23,14,9,3,9,2
2020-08-24,PVT,160,53,107,85,22,27,2,56
2020-08-24,PVT2,239,56,183,159,24,84,1,74
2020-08-24,MP1,377,62,315,274,41,198,6,70
2020-08-24,MP1m,53,4,49,45,4,35,1,9
2020-08-24,MP2,756,79,677,640,37,550,11,79
2020-08-24,MP3,703,80,623,587,36,491,25,71
2020-08-24,MP4,642,31,611,535,76,449,40,46
2020-08-24,MP5,23,1,23,16,7,4,10,2
2020-08-25,PVT,160,53,107,85,22,27,3,55
2020-08-25,PVT2,239,57,182,158,24,84,2,72
2020-08-25,MP1,377,63,314,273,41,199,4,70
2020-08-25,MP1m,53,4,49,45,4,35,1,9
2020-08-25,MP2,756,79,677,640,37,548,14,78
2020-08-25,MP3,703,82,621,586,35,491,23,72
2020-08-25,MP4,642,35,607,534,73,456,36,42
2020-08-25,MP5,23,1,23,17,6,5,10,2
2020-08-26,PVT,160,53,107,85,22,28,2,55
2020-08-26,PVT2,239,57,182,158,24,83,2,73
2020-08-26,MP1,377,63,314,273,41,199,5,69
2020-08-26,MP1m,53,4,49,45,4,35,1,9
2020-08-26,MP2,756,79,677,640,37,545,12,83
2020-08-26,MP3,703,82,621,586,35,488,19,79
2020-08-26,MP4,642,35,607,534,73,463,31,40
2020-08-26,MP5,86,1,86,18,68,6,10,2
2020-08-27,PVT,160,53,107,85,22,27,3,55
2020-08-27,PVT2,239,57,182,158,24,81,2,75
2020-08-27,MP1,377,63,314,273,41,199,4,70
2020-08-27,MP1m,53,4,49,45,4,35,1,9
2020-08-27,MP2,756,79,677,640,37,547,9,84
2020-08-27,MP3,703,82,621,586,35,488,19,79
2020-08-27,MP4,642,35,607,535,72,468,26,41
2020-08-27,MP5,86,1,86,18,68,10,8,0
2020-08-28,PVT,160,53,107,85,22,27,3,55
2020-08-28,PVT2,239,58,181,157,24,82,1,74
2020-08-28,MP1,377,63,314,273,41,202,1,70
2020-08-28,MP1m,53,4,49,45,4,35,0,10
2020-08-28,MP2,756,79,677,640,37,541,14,85
2020-08-28,MP3,703,83,620,586,34,479,26,81
2020-08-28,MP4,642,38,604,533,71,465,30,38
2020-08-28,MP5,131,1,131,31,100,11,8,12
2020-08-29,PVT,160,53,107,85,22,29,2,54
2020-08-29,PVT2,239,58,181,157,24,82,1,74
2020-08-29,MP1,377,63,314,273,41,203,1,69
2020-08-29,MP1m,53,4,49,45,4,35,0,10
2020-08-29,MP2,756,80,676,639,37,539,17,83
2020-08-29,MP3,703,83,620,586,34,476,28,82
2020-08-29,MP4,642,38,604,534,70,467,26,41
2020-08-29,MP5,131,1,131,41,90,13,17,11
2020-08-30,PVT,160,53,107,85,22,30,1,54
2020-08-30,PVT2,239,58,181,157,24,83,0,74
2020-08-30,MP1,377,63,314,273,41,201,1,71
2020-08-30,MP1m,53,4,49,45,4,35,0,10
2020-08-30,MP2,756,80,676,639,37,539,16,84
2020-08-30,MP3,703,83,620,587,33,478,22,87
2020-08-30,MP4,642,38,604,535,69,472,24,39
2020-08-30,MP5,131,1,131,56,75,14,24,18
2020-08-31,PVT,160,53,107,85,22,30,0,55
2020-08-31,PVT2,239,58,181,157,24,83,0,74
2020-08-31,MP1,377,63,314,274,40,198,1,75
2020-08-31,MP1m,53,4,49,45,4,36,0,9
2020-08-31,MP2,756,81,675,638,37,535,17,86
2020-08-31,MP3,703,83,620,587,33,477,24,86
2020-08-31,MP4,642,38,604,537,67,474,21,42
2020-08-31,MP5,131,1,131,68,63,14,37,17
2020-09-01,PVT,160,53,107,85,22,30,0,55
2020-09-01,PVT2,239,58,181,157,24,83,0,74
2020-09-01,MP1,377,63,314,274,40,197,1,76
2020-09-01,MP1m,53,4,49,45,4,36,0,9
2020-09-01,MP2,756,81,675,638,37,532,17,89
2020-09-01,MP3,703,83,620,587,33,473,29,85
2020-09-01,MP4,642,40,602,537,65,469,25,43
2020-09-01,MP5,131,1,131,81,50,16,44,21
2020-09-02,PVT,160,53,107,85,22,30,0,55
2020-09-02,PVT2,239,58,181,157,24,83,0,74
2020-09-02,MP1,377,63,314,274,40,196,3,75
2020-09-02,MP1m,53,4,49,45,4,36,0,9
2020-09-02,MP2,756,81,675,638,37,533,17,88
2020-09-02,MP3,703,83,620,587,33,472,23,92
2020-09-02,MP4,642,40,602,538,64,468,24,46
2020-09-02,MP5,169,1,169,89,80,17,60,12
2020-09-03,PVT,160,53,107,85,22,30,0,55
2020-09-03,PVT2,239,58,181,157,24,83,0,74
2020-09-03,MP1,377,63,314,274,40,194,4,76
2020-09-03,MP1m,53,4,49,45,4,36,0,9
2020-09-03,MP2,756,81,675,638,37,529,18,91
2020-09-03,MP3,703,83,620,587,33,470,20,97
2020-09-03,MP4,642,40,602,540,62,466,26,48
2020-09-03,MP5,169,1,169,95,74,28,54,13
2020-09-04,PVT,160,53,107,85,22,29,0,56
2020-09-04,PVT2,239,58,181,157,24,81,1,75
2020-09-04,MP1,377,63,314,274,40,194,5,75
2020-09-04,MP1m,53,4,49,45,4,36,0,9
2020-09-04,MP2,756,81,675,638,37,532,15,91
2020-09-04,MP3,703,83,620,587,33,467,20,100
2020-09-04,MP4,642,40,602,540,62,465,29,46
2020-09-04,MP5,169,1,169,98,71,34,52,12
2020-09-05,PVT,160,53,107,85,22,29,0,56
2020-09-05,PVT2,239,58,181,157,24,80,1,76
2020-09-05,MP1,377,63,314,274,40,194,4,76
2020-09-05,MP1m,53,4,49,45,4,36,0,9
2020-09-05,MP2,756,81,675,638,37,533,12,93
2020-09-05,MP3,703,83,620,587,33,465,19,103
2020-09-05,MP4,642,40,602,541,61,463,29,49
2020-09-05,MP5,199,1,199,99,100,44,49,6
2020-09-06,PVT,160,53,107,85,22,29,1,55
2020-09-06,PVT2,239,58,181,157,24,80,1,76
2020-09-06,MP1,377,63,314,274,40,191,4,79
2020-09-06,MP1m,53,4,49,45,4,36,0,9
2020-09-06,MP2,756,81,675,638,37,532,12,94
2020-09-06,MP3,703,83,620,587,33,466,21,100
2020-09-06,MP4,642,40,602,541,61,460,29,52
2020-09-06,MP5,199,1,199,103,96,56,38,9
2020-09-07,PVT,160,53,107,85,22,28,1,56
2020-09-07,PVT2,239,58,181,157,24,80,2,75
2020-09-07,MP1,377,63,314,274,40,190,4,80
2020-09-07,MP1m,53,4,49,45,4,36,0,9
2020-09-07,MP2,756,81,675,638,37,529,15,94
2020-09-07,MP3,703,83,620,587,33,465,23,99
2020-09-07,MP4,642,40,602,541,61,456,31,54
2020-09-07,MP5,199,1,199,108,91,70,28,10
2020-09-08,PVT,160,53,107,85,22,28,0,57
2020-09-08,PVT2,239,58,181,157,24,79,2,76
2020-09-08,MP1,377,63,314,274,40,192,2,80
2020-09-08,MP1m,53,4,49,45,4,36,0,9
2020-09-08,MP2,756,81,675,638,37,531,12,95
2020-09-08,MP3,703,83,620,588,32,461,21,106
2020-09-08,MP4,642,40,602,543,59,457,29,57
2020-09-08,MP5,199,1,199,114,85,79,23,12
2020-09-09,PVT,160,53,107,85,22,28,0,57
2020-09-09,PVT2,239,58,181,157,24,80,1,76
2020-09-09,MP1,377,63,314,275,39,190,2,83
2020-09-09,MP1m,53,4,49,45,4,36,0,9
2020-09-09,MP2,756,81,675,638,37,525,12,101
2020-09-09,MP3,703,83,620,588,32,461,17,110
2020-09-09,MP4,642,40,602,544,58,454,29,61
2020-09-09,MP5,226,1,226,126,100,81,23,22
2020-09-10,PVT,160,53,107,85,22,29,0,56
2020-09-10,PVT2,239,58,181,157,24,80,1,76
2020-09-10,MP1,377,63,314,275,39,189,3,83
2020-09-10,MP1m,53,4,49,45,4,36,0,9
2020-09-10,MP2,756,81,675,639,36,521,14,104
2020-09-10,MP3,703,83,620,588,32,464,18,106
2020-09-10,MP4,642,40,602,544,58,452,30,62
2020-09-10,MP5,226,1,226,140,86,84,28,28
2020-09-11,PVT,160,53,107,85,22,30,0,55
2020-09-11,PVT2,239,62,177,153,24,78,1,74
2020-09-11,MP1,377,64,313,274,39,187,3,84
2020-09-11,MP1m,53,4,49,45,4,36,0,9
2020-09-11,MP2,756,84,672,636,36,520,13,103
2020-09-11,MP3,703,86,617,585,32,460,24,101
2020-09-11,MP4,642,48,594,538,56,450,29,59
2020-09-11,MP5,251,5,247,143,104,89,41,13
2020-09-12,PVT,160,53,107,85,22,30,0,55
2020-09-12,PVT2,239,62,177,153,24,78,1,74
2020-09-12,MP1,377,64,313,274,39,185,3,86
2020-09-12,MP1m,53,4,49,45,4,36,0,9
2020-09-12,MP2,756,85,671,635,36,517,13,105
2020-09-12,MP3,703,86,617,585,32,452,27,106
2020-09-12,MP4,642,48,594,538,56,453,26,59
2020-09-12,MP5,251,5,247,144,103,91,43,10
2020-09-13,PVT,160,53,107,85,22,30,0,55
2020-09-13,PVT2,239,62,177,153,24,78,1,74
2020-09-13,MP1,377,64,313,274,39,186,3,85
2020-09-13,MP1m,53,4,49,45,4,37,0,8
2020-09-13,MP2,756,85,671,635,36,519,11,105
2020-09-13,MP3,703,86,617,585,32,445,28,112
2020-09-13,MP4,642,48,594,539,55,448,28,63
2020-09-13,MP5,251,5,247,151,96,95,44,12
2020-09-14,PVT,160,53,107,85,22,29,0,56
2020-09-14,PVT2,239,62,177,153,24,77,1,75
2020-09-14,MP1,377,64,313,274,39,184,4,86
2020-09-14,MP1m,53,4,49,45,4,37,0,8
2020-09-14,MP2,756,85,671,635,36,519,10,106
2020-09-14,MP3,703,86,617,585,32,441,31,113
2020-09-14,MP4,642,48,594,539,55,443,27,69
2020-09-14,MP5,251,5,247,157,90,97,45,15
2020-09-15,PVT,160,53,107,85,22,28,1,56
2020-09-15,PVT2,239,62,177,153,24,77,1,75
2020-09-15,MP1,377,65,312,273,39,184,6,83
2020-09-15,MP1m,53,4,49,45,4,36,0,9
2020-09-15,MP2,756,87,669,633,36,512,14,107
2020-09-15,MP3,703,90,613,581,32,438,33,110
2020-09-15,MP4,642,52,590,535,55,437,32,66
2020-09-15,MP5,251,7,245,168,77,104,43,21
2020-09-16,PVT,160,53,107,85,22,27,2,56
2020-09-16,PVT2,239,62,177,153,24,75,3,75
2020-09-16,MP1,377,65,312,273,39,181,8,84
2020-09-16,MP1m,53,4,49,45,4,36,0,9
2020-09-16,MP2,756,87,669,633,36,512,13,108
2020-09-16,MP3,703,90,613,581,32,440,25,116
2020-09-16,MP4,642,52,590,535,55,437,30,68
2020-09-16,MP5,267,7,261,179,82,117,43,19
2020-09-17,PVT,160,53,107,85,22,27,2,56
2020-09-17,PVT2,239,62,177,153,24,74,3,76
2020-09-17,MP1,377,65,312,273,39,183,11,79
2020-09-17,MP1m,53,4,49,45,4,36,0,9
2020-09-17,MP2,756,87,669,634,35,509,12,113
2020-09-17,MP3,703,90,613,581,32,435,26,120
2020-09-17,MP4,642,52,590,535,55,435,30,70
2020-09-17,MP5,267,7,261,180,81,125,43,12
2020-09-18,PVT,160,53,107,85,22,27,2,56
2020-09-18,PVT2,239,63,176,153,23,75,4,74
2020-09-18,MP1,377,66,311,272,39,183,10,79
2020-09-18,MP1m,53,4,49,45,4,36,0,9
2020-09-18,MP2,756,89,667,632,35,507,13,112
2020-09-18,MP3,703,92,611,579,32,433,23,123
2020-09-18,MP4,642,58,584,530,54,431,29,70
2020-09-18,MP5,267,11,257,180,77,125,45,10
2020-09-19,PVT,160,53,107,85,22,27,2,56
2020-09-19,PVT2,239,63,176,153,23,75,3,75
2020-09-19,MP1,377,66,311,272,39,184,9,79
2020-09-19,MP1m,53,4,49,45,4,36,0,9
2020-09-19,MP2,756,89,667,632,35,505,11,116
2020-09-19,MP3,703,92,611,579,32,425,25,129
2020-09-19,MP4,642,58,584,530,54,429,25,76
2020-09-19,MP5,267,11,257,187,70,135,39,13
2020-09-20,PVT,160,53,107,85,22,27,2,56
2020-09-20,PVT2,239,63,176,153,23,74,3,76
2020-09-20,MP1,377,66,311,272,39,182,9,81
2020-09-20,MP1m,53,4,49,45,4,36,0,9
2020-09-20,MP2,756,89,667,632,35,502,8,122
2020-09-20,MP3,703,92,611,579,32,420,27,132
2020-09-20,MP4,642,58,584,530,54,425,26,79
2020-09-20,MP5,267,11,257,192,65,137,43,12
2020-09-21,PVT,160,53,107,85,22,27,1,57
2020-09-21,PVT2,239,63,176,153,23,75,2,76
2020-09-21,MP1,377,66,311,272,39,183,4,85
2020-09-21,MP1m,53,4,49,45,4,35,0,10
2020-09-21,MP2,756,89,667,632,35,496,13,123
2020-09-21,MP3,703,92,611,579,32,412,31,136
2020-09-21,MP4,642,58,584,530,54,416,36,78
2020-09-21,MP5,286,11,276,198,78,142,41,15
2020-09-22,PVT,160,53,107,85,22,28,0,57
2020-09-22,PVT2,239,63,176,153,23,73,2,78
2020-09-22,MP1,377,66,311,272,39,185,3,84
2020-09-22,MP1m,53,4,49,45,4,36,0,9
2020-09-22,MP2,756,89,667,632,35,491,14,127
2020-09-22,MP3,703,95,608,576,32,406,28,142
2020-09-22,MP4,642,60,582,529,53,409,33,87
2020-09-22,MP5,286,12,275,197,78,154,33,10
2020-09-23,PVT,160,53,107,85,22,28,0,57
2020-09-23,PVT2,239,63,176,153,23,74,1,78
2020-09-23,MP1,377,66,311,272,39,184,5,83
2020-09-23,MP1m,53,4,49,45,4,35,0,10
2020-09-23,MP2,756,89,667,632,35,488,19,125
2020-09-23,MP3,703,95,608,576,32,405,27,144
2020-09-23,MP4,642,61,581,528,53,404,34,90
2020-09-23,MP5,286,12,275,200,75,155,33,12
2020-09-24,PVT,160,53,107,85,22,27,0,58
2020-09-24,PVT2,239,63,176,153,23,74,0,79
2020-09-24,MP1,377,66,311,272,39,183,6,83
2020-09-24,MP1m,53,4,49,45,4,35,0,10
2020-09-24,MP2,756,89,667,632,35,488,20,124
2020-09-24,MP3,703,95,608,576,32,402,24,150
2020-09-24,MP4,642,63,579,526,53,400,34,92
2020-09-24,MP5,286,12,275,206,69,160,29,17
2020-09-25,PVT,160,53,107,85,22,27,0,58
2020-09-25,PVT2,239,63,176,153,23,73,1,79
2020-09-25,MP1,377,67,310,271,39,181,5,85
2020-09-25,MP1m,53,4,49,45,4,35,0,10
2020-09-25,MP2,756,89,667,632,35,482,23,127
2020-09-25,MP3,703,95,608,576,32,395,24,157
2020-09-25,MP4,642,63,579,526,53,394,33,99
2020-09-25,MP5,325,12,314,212,102,164,27,21
2020-09-26,PVT,160,53,107,85,22,27,0,58
2020-09-26,PVT2,239,63,176,153,23,73,1,79
2020-09-26,MP1,377,67,310,271,39,177,7,87
2020-09-26,MP1m,53,4,49,45,4,34,0,11
2020-09-26,MP2,756,89,667,632,35,482,19,131
2020-09-26,MP3,703,95,608,576,32,388,21,167
2020-09-26,MP4,642,63,579,526,53,394,23,109
2020-09-26,MP5,325,12,314,214,100,166,28,20
2020-09-27,PVT,160,53,107,85,22,26,0,59
2020-09-27,PVT2,239,63,176,153,23,74,1,78
2020-09-27,MP1,377,67,310,271,39,179,7,85
2020-09-27,MP1m,53,4,49,45,4,34,0,11
2020-09-27,MP2,756,89,667,632,35,480,17,135
2020-09-27,MP3,703,95,608,576,32,389,15,172
2020-09-27,MP4,642,63,579,526,53,387,23,116
2020-09-27,MP5,325,12,314,217,97,172,26,19
2020-09-28,PVT,160,53,107,85,22,26,1,58
2020-09-28,PVT2,239,63,176,153,23,72,1,80
2020-09-28,MP1,377,68,309,270,39,179,7,84
2020-09-28,MP1m,53,4,49,45,4,34,1,10
2020-09-28,MP2,756,90,666,631,35,475,17,139
2020-09-28,MP3,703,95,608,576,32,385,15,176
2020-09-28,MP4,642,64,578,525,53,382,23,120
2020-09-28,MP5,325,15,311,216,95,170,27,19
2020-09-29,PVT,160,53,107,85,22,26,1,58
2020-09-29,PVT2,239,63,176,153,23,70,1,82
2020-09-29,MP1,377,68,309,270,39,178,7,85
2020-09-29,MP1m,53,5,48,44,4,34,1,9
2020-09-29,MP2,756,91,665,630,35,473,18,139
2020-09-29,MP3,703,95,608,576,32,375,21,180
2020-09-29,MP4,642,64,578,525,53,380,24,121
2020-09-29,MP5,345,15,331,220,111,171,28,21
2020-09-30,PVT,160,53,107,85,22,26,1,58
2020-09-30,PVT2,239,63,176,153,23,69,1,83
2020-09-30,MP1,377,68,309,270,39,176,4,90
2020-09-30,MP1m,53,5,48,44,4,34,1,9
2020-09-30,MP2,756,91,665,630,35,475,12,143
2020-09-30,MP3,703,95,608,576,32,371,22,183
2020-09-30,MP4,642,64,578,525,53,381,23,121
2020-09-30,MP5,350,15,336,230,106,170,32,28
2020-10-01,PVT,160,53,107,85,22,26,1,58
2020-10-01,PVT2,239,64,175,152,23,67,1,84
2020-10-01,MP1,377,70,307,268,39,177,2,89
2020-10-01,MP1m,53,5,48,44,4,34,1,9
2020-10-01,MP2,756,91,665,630,35,471,10,149
2020-10-01,MP3,703,95,608,576,32,365,23,188
2020-10-01,MP4,642,64,578,525,53,382,19,124
2020-10-01,MP5,357,17,341,232,109,173,37,22
2020-10-02,PVT,160,54,106,84,22,26,1,57
2020-10-02,PVT2,239,66,173,150,23,64,2,84
2020-10-02,MP1,377,72,305,266,39,175,3,88
2020-10-02,MP1m,53,5,48,44,4,34,1,9
2020-10-02,MP2,756,92,664,629,35,466,11,152
2020-10-02,MP3,703,96,607,575,32,362,24,189
2020-10-02,MP4,642,64,578,525,53,379,19,127
2020-10-02,MP5,365,18,348,238,110,175,37,26
2020-10-03,PVT,160,54,106,84,22,25,2,57
2020-10-03,PVT2,239,66,173,150,23,64,2,84
2020-10-03,MP1,377,72,305,266,39,174,5,87
2020-10-03,MP1m,53,5,48,44,4,35,0,9
2020-10-03,MP2,756,92,664,629,35,462,10,157
2020-10-03,MP3,703,97,606,574,32,361,21,192
2020-10-03,MP4,642,64,578,525,53,374,23,128
2020-10-03,MP5,365,18,348,245,103,180,38,27
2020-10-04,PVT,160,54,106,84,22,25,2,57
2020-10-04,PVT2,239,66,173,150,23,64,2,84
2020-10-04,MP1,377,72,305,266,39,174,5,87
2020-10-04,MP1m,53,5,48,44,4,35,0,9
2020-10-04,MP2,756,92,664,629,35,460,9,160
2020-10-04,MP3,703,97,606,574,32,357,20,197
2020-10-04,MP4,642,64,578,525,53,368,22,135
2020-10-04,MP5,365,18,348,257,91,183,40,34
2020-10-05,PVT,160,54,106,84,22,26,0,58
2020-10-05,PVT2,239,66,173,150,23,65,3,82
2020-10-05,MP1,377,73,304,265,39,172,5,88
2020-10-05,MP1m,53,5,48,44,4,34,0,10
2020-10-05,MP2,756,92,664,629,35,454,9,166
2020-10-05,MP3,703,97,606,574,32,344,28,202
2020-10-05,MP4,642,64,578,525,53,367,22,136
2020-10-05,MP5,375,19,357,260,97,184,45,31
2020-10-06,PVT,160,54,106,84,22,26,0,58
2020-10-06,PVT2,239,66,173,150,23,65,2,83
2020-10-06,MP1,377,73,304,265,39,172,4,89
2020-10-06,MP1m,53,5,48,44,4,34,0,10
2020-10-06,MP2,756,93,663,628,35,449,11,168
2020-10-06,MP3,703,97,606,574,32,337,29,208
2020-10-06,MP4,642,64,578,525,53,363,24,138
2020-10-06,MP5,384,19,366,268,98,189,47,32
2020-10-07,PVT,160,54,106,84,22,26,0,58
2020-10-07,PVT2,239,66,173,150,23,64,1,85
2020-10-07,MP1,377,73,304,265,39,171,4,90
2020-10-07,MP1m,53,5,48,44,4,34,0,10
2020-10-07,MP2,756,93,663,628,35,446,7,175
2020-10-07,MP3,703,97,606,574,32,335,24,215
2020-10-07,MP4,642,64,578,525,53,357,27,141
2020-10-07,MP5,388,19,370,272,98,194,47,31
2020-10-08,PVT,160,54,106,84,22,26,1,57
2020-10-08,PVT2,239,66,173,150,23,63,0,87
2020-10-08,MP1,377,73,304,265,39,172,3,90
2020-10-08,MP1m,53,5,48,44,4,34,0,10
2020-10-08,MP2,756,94,663,628,35,444,5,179
2020-10-08,MP3,703,97,606,574,32,332,28,214
2020-10-08,MP4,642,65,577,524,53,356,24,144
2020-10-08,MP5,388,20,369,276,93,198,46,32
2020-10-09,PVT,160,54,106,84,22,26,1,57
2020-10-09,PVT2,239,66,173,150,23,63,0,87
2020-10-09,MP1,377,73,304,265,39,172,2,91
2020-10-09,MP1m,53,5,48,44,4,34,0,10
2020-10-09,MP2,756,95,662,627,35,441,8,178
2020-10-09,MP3,703,97,606,574,32,326,29,219
2020-10-09,MP4,642,66,576,523,53,351,23,149
2020-10-09,MP5,388,20,369,284,85,205,45,34
2020-10-10,PVT,160,54,106,84,22,25,1,58
2020-10-10,PVT2,239,66,173,150,23,63,0,87
2020-10-10,MP1,377,73,304,265,39,170,1,94
2020-10-10,MP1m,53,5,48,44,4,32,0,12
2020-10-10,MP2,756,95,662,627,35,442,8,177
2020-10-10,MP3,703,97,606,574,32,319,23,232
2020-10-10,MP4,642,66,576,523,53,351,20,152
2020-10-10,MP5,388,20,369,288,81,211,44,33
2020-10-11,PVT,160,54,106,84,22,25,1,58
2020-10-11,PVT2,239,66,173,150,23,63,1,86
2020-10-11,MP1,377,73,304,265,39,168,1,96
2020-10-11,MP1m,53,5,48,44,4,32,0,12
2020-10-11,MP2,756,95,662,627,35,438,8,181
2020-10-11,MP3,703,97,606,574,32,316,18,240
2020-10-11,MP4,642,66,576,523,53,349,17,157
2020-10-11,MP5,388,20,369,293,76,217,43,33
2020-10-12,PVT,160,55,105,83,22,24,1,58
2020-10-12,PVT2,239,67,172,149,23,63,1,85
2020-10-12,MP1,377,73,304,265,39,165,2,98
2020-10-12,MP1m,53,5,48,44,4,32,0,12
2020-10-12,MP2,756,95,662,627,35,438,7,182
2020-10-12,MP3,703,97,606,574,32,310,20,244
2020-10-12,MP4,642,67,575,522,53,345,18,159
2020-10-12,MP5,420,21,399,298,101,220,43,35
2020-10-13,PVT,160,56,104,82,22,25,0,57
2020-10-13,PVT2,239,68,171,148,23,62,2,84
2020-10-13,MP1,377,77,300,261,39,163,4,94
2020-10-13,MP1m,53,5,48,44,4,32,0,12
2020-10-13,MP2,756,97,660,626,34,433,7,186
2020-10-13,MP3,703,102,601,569,32,302,18,249
2020-10-13,MP4,642,75,567,515,52,343,21,151
2020-10-13,MP5,428,28,400,294,106,221,46,27
2020-10-14,PVT,160,56,104,82,22,25,0,57
2020-10-14,PVT2,239,68,171,148,23,62,3,83
2020-10-14,MP1,377,77,300,261,39,163,4,94
2020-10-14,MP1m,53,5,48,44,4,32,0,12
2020-10-14,MP2,756,97,660,626,34,429,12,185
2020-10-14,MP3,703,102,601,569,32,302,13,254
2020-10-14,MP4,642,76,566,514,52,337,24,153
2020-10-14,MP5,429,28,401,297,104,226,40,31
2020-10-15,PVT,160,56,104,82,22,25,0,57
2020-10-15,PVT2,239,68,171,148,23,63,3,82
2020-10-15,MP1,377,77,300,261,39,163,4,94
2020-10-15,MP1m,53,5,48,44,4,32,0,12
2020-10-15,MP2,756,97,660,626,34,428,16,182
2020-10-15,MP3,703,102,601,569,32,302,13,254
2020-10-15,MP4,642,77,565,513,52,333,26,154
2020-10-15,MP5,429,28,401,303,98,233,36,34
2020-10-16,PVT,160,56,104,82,22,25,0,57
2020-10-16,PVT2,239,68,171,148,23,60,4,84
2020-10-16,MP1,377,77,300,261,39,163,4,94
2020-10-16,MP1m,53,5,48,44,4,32,1,11
2020-10-16,MP2,756,97,660,626,34,424,13,189
2020-10-16,MP3,703,102,601,569,32,297,16,256
2020-10-16,MP4,642,77,565,513,52,329,22,162
2020-10-16,MP5,437,28,409,308,101,235,36,37
2020-10-17,PVT,160,56,104,82,22,25,0,57
2020-10-17,PVT2,239,68,171,148,23,60,3,85
2020-10-17,MP1,377,77,300,261,39,163,4,94
2020-10-17,MP1m,53,5,48,44,4,32,1,11
2020-10-17,MP2,756,97,660,626,34,416,16,194
2020-10-17,MP3,703,102,601,569,32,296,13,260
2020-10-17,MP4,642,77,565,513,52,330,20,163
2020-10-17,MP5,437,28,409,312,97,241,34,37
2020-10-18,PVT,160,56,104,82,22,25,0,57
2020-10-18,PVT2,239,68,171,148,23,58,3,87
2020-10-18,MP1,377,77,300,261,39,163,3,95
2020-10-18,MP1m,53,5,48,44,4,33,0,11
2020-10-18,MP2,756,97,660,626,34,416,13,197
2020-10-18,MP3,703,102,601,569,32,288,19,262
2020-10-18,MP4,642,77,565,513,52,322,20,171
2020-10-18,MP5,437,28,409,317,92,244,31,42
2020-10-19,PVT,160,56,104,83,21,25,0,58
2020-10-19,PVT2,239,68,171,148,23,58,2,88
2020-10-19,MP1,377,77,300,261,39,164,2,95
2020-10-19,MP1m,53,5,48,44,4,33,0,11
2020-10-19,MP2,756,97,660,626,34,418,10,198
2020-10-19,MP3,703,102,601,569,32,281,23,265
2020-10-19,MP4,642,77,565,513,52,323,13,177
2020-10-19,MP5,464,28,436,318,118,242,34,42
2020-10-20,PVT,160,56,104,83,21,25,1,57
2020-10-20,PVT2,239,68,171,148,23,58,2,88
2020-10-20,MP1,377,77,300,261,39,164,1,96
2020-10-20,MP1m,53,5,48,44,4,33,0,11
2020-10-20,MP2,756,97,660,626,34,421,10,195
2020-10-20,MP3,703,102,601,569,32,283,17,269
2020-10-20,MP4,642,77,565,513,52,316,15,182
2020-10-20,MP5,482,28,454,320,134,245,34,41
2020-10-21,PVT,160,56,104,83,21,25,1,57
2020-10-21,PVT2,239,68,171,148,23,58,1,89
2020-10-21,MP1,377,77,300,261,39,162,3,96
2020-10-21,MP1m,53,5,48,44,4,33,0,11
2020-10-21,MP2,756,97,660,626,34,420,10,196
2020-10-21,MP3,703,102,601,569,32,278,17,274
2020-10-21,MP4,642,77,565,513,52,315,15,183
2020-10-21,MP5,483,28,455,324,131,248,31,45
2020-10-22,PVT,160,56,104,83,21,25,1,57
2020-10-22,PVT2,239,68,171,148,23,56,3,89
2020-10-22,MP1,377,77,300,261,39,163,3,95
2020-10-22,MP1m,53,5,48,44,4,33,0,11
2020-10-22,MP2,756,97,660,626,34,417,8,201
2020-10-22,MP3,703,102,601,569,32,274,21,274
2020-10-22,MP4,642,77,565,513,52,311,21,181
2020-10-22,MP5,486,28,458,330,128,250,33,47
2020-10-23,PVT,160,56,104,83,21,25,1,57
2020-10-23,PVT2,239,68,171,148,23,56,2,90
2020-10-23,MP1,377,77,300,261,39,160,3,98
2020-10-23,MP1m,53,5,48,44,4,33,1,10
2020-10-23,MP2,756,97,660,626,34,414,7,205
2020-10-23,MP3,703,102,601,569,32,271,16,282
2020-10-23,MP4,642,77,565,513,52,307,18,188
2020-10-23,MP5,494,28,466,339,127,249,39,51
2020-10-24,PVT,160,56,104,83,21,25,1,57
2020-10-24,PVT2,239,68,171,148,23,56,2,90
2020-10-24,MP1,377,77,300,261,39,160,4,97
2020-10-24,MP1m,53,5,48,44,4,33,1,10
2020-10-24,MP2,756,97,660,626,34,413,6,207
2020-10-24,MP3,703,102,601,569,32,268,13,288
2020-10-24,MP4,642,77,565,513,52,303,22,188
2020-10-24,MP5,494,28,466,344,122,256,37,51
2020-10-25,PVT,160,56,104,83,21,26,0,57
2020-10-25,PVT2,239,68,171,148,23,58,1,89
2020-10-25,MP1,377,77,300,261,39,160,4,97
2020-10-25,MP1m,53,5,48,44,4,33,1,10
2020-10-25,MP2,756,97,660,626,34,405,11,210
2020-10-25,MP3,703,102,601,569,32,267,12,290
2020-10-25,MP4,642,77,565,513,52,303,19,191
2020-10-25,MP5,494,28,466,349,117,259,38,52
2020-10-26,PVT,160,56,104,83,21,26,0,57
2020-10-26,PVT2,239,71,169,146,23,57,2,87
2020-10-26,MP1,377,83,294,255,39,157,3,95
2020-10-26,MP1m,53,5,48,44,4,32,1,11
2020-10-26,MP2,756,98,659,625,34,404,10,211
2020-10-26,MP3,703,108,595,563,32,261,16,286
2020-10-26,MP4,642,80,562,510,52,299,19,192
2020-10-26,MP5,508,33,476,348,128,257,40,51
2020-10-27,PVT,160,56,104,83,21,26,0,57
2020-10-27,PVT2,239,71,169,146,23,56,1,89
2020-10-27,MP1,377,83,294,255,39,157,4,94
2020-10-27,MP1m,53,5,48,44,4,32,1,11
2020-10-27,MP2,756,98,659,625,34,400,9,216
2020-10-27,MP3,703,109,594,562,32,260,15,287
2020-10-27,MP4,642,80,562,510,52,292,19,199
2020-10-27,MP5,515,33,483,351,132,261,39,51
2020-10-28,PVT,160,56,104,83,21,26,0,57
2020-10-28,PVT2,239,71,169,146,23,55,1,90
2020-10-28,MP1,377,83,294,255,39,157,4,94
2020-10-28,MP1m,53,5,48,44,4,32,1,11
2020-10-28,MP2,756,98,659,625,34,396,12,217
2020-10-28,MP3,703,109,594,562,32,258,15,289
2020-10-28,MP4,642,80,562,510,52,294,16,200
2020-10-28,MP5,521,33,489,353,136,268,32,53
2020-10-29,PVT,160,56,104,83,21,25,0,58
2020-10-29,PVT2,239,71,169,146,23,55,1,90
2020-10-29,MP1,377,83,294,255,39,154,5,96
2020-10-29,MP1m,53,5,48,44,4,33,0,11
2020-10-29,MP2,756,98,659,625,34,396,8,221
2020-10-29,MP3,703,109,594,562,32,259,13,290
2020-10-29,MP4,642,80,562,510,52,294,13,203
2020-10-29,MP5,525,33,493,356,137,266,34,56
2020-10-30,PVT,160,56,104,83,21,25,0,58
2020-10-30,PVT2,239,71,169,146,23,56,1,89
2020-10-30,MP1,377,83,294,255,39,154,5,96
2020-10-30,MP1m,53,5,48,44,4,33,0,11
2020-10-30,MP2,756,99,658,624,34,394,5,225
2020-10-30,MP3,703,109,594,562,32,255,14,293
2020-10-30,MP4,642,80,562,510,52,290,12,208
2020-10-30,MP5,532,33,500,361,139,266,36,59
2020-10-31,PVT,160,56,104,83,21,25,0,58
2020-10-31,PVT2,239,71,169,146,23,57,0,89
2020-10-31,MP1,377,83,294,255,39,150,7,98
2020-10-31,MP1m,53,5,48,44,4,33,0,11
2020-10-31,MP2,756,99,658,624,34,393,5,226
2020-10-31,MP3,703,109,594,563,31,251,13,299
2020-10-31,MP4,642,80,562,510,52,285,10,215
2020-10-31,MP5,532,33,500,368,132,268,40,60
2020-11-01,PVT,160,56,104,83,21,23,1,59
2020-11-01,PVT2,239,71,169,146,23,56,0,90
2020-11-01,MP1,377,83,294,255,39,149,6,100
2020-11-01,MP1m,53,5,48,44,4,33,0,11
2020-11-01,MP2,756,99,658,624,34,392,5,227
2020-11-01,MP3,703,109,594,563,31,250,12,301
2020-11-01,MP4,642,80,562,510,52,283,10,217
2020-11-01,MP5,532,33,500,377,123,267,44,66
2020-11-02,PVT,160,56,104,83,21,23,1,59
2020-11-02,PVT2,239,72,168,146,22,56,0,90
2020-11-02,MP1,377,83,294,255,39,144,7,104
2020-11-02,MP1m,53,5,48,45,3,34,0,11
2020-11-02,MP2,756,99,658,624,34,388,8,228
2020-11-02,MP3,703,110,593,562,31,245,13,304
2020-11-02,MP4,642,80,562,510,52,279,13,218
2020-11-02,MP5,542,33,510,381,129,268,47,66
2020-11-03,PVT,160,56,104,83,21,21,1,61
2020-11-03,PVT2,239,72,168,146,22,57,0,89
2020-11-03,MP1,377,84,293,254,39,143,7,104
2020-11-03,MP1m,53,5,48,45,3,33,2,10
2020-11-03,MP2,756,99,658,624,34,387,8,229
2020-11-03,MP3,703,110,593,562,31,244,12,306
2020-11-03,MP4,642,80,562,510,52,272,19,219
2020-11-03,MP5,546,33,514,386,128,264,48,74
2020-11-04,PVT,160,56,104,83,21,21,0,62
2020-11-04,PVT2,239,72,168,146,22,54,0,92
2020-11-04,MP1,377,84,293,254,39,140,8,106
2020-11-04,MP1m,53,5,48,45,3,32,3,10
2020-11-04,MP2,756,99,658,624,34,379,14,231
2020-11-04,MP3,703,110,593,562,31,243,14,305
2020-11-04,MP4,642,80,562,510,52,270,22,218
2020-11-04,MP5,550,33,518,391,127,260,54,77
2020-11-05,PVT,160,56,104,83,21,22,0,61
2020-11-05,PVT2,239,72,168,146,22,53,1,92
2020-11-05,MP1,377,85,292,253,39,139,9,105
2020-11-05,MP1m,53,5,48,45,3,32,3,10
2020-11-05,MP2,756,99,658,624,34,375,17,232
2020-11-05,MP3,703,111,592,561,31,241,14,306
2020-11-05,MP4,642,80,562,510,52,266,25,219
2020-11-05,MP5,557,33,525,397,128,263,52,82
2020-11-06,PVT,160,56,104,83,21,22,0,61
2020-11-06,PVT2,239,72,168,146,22,53,1,92
2020-11-06,MP1,377,85,292,253,39,138,10,105
2020-11-06,MP1m,53,5,48,45,3,31,3,11
2020-11-06,MP2,756,99,658,624,34,372,18,234
2020-11-06,MP3,703,111,592,561,31,238,13,310
2020-11-06,MP4,642,80,562,510,52,266,23,221
2020-11-06,MP5,559,33,527,399,128,266,54,79
2020-11-07,PVT,160,56,104,83,21,22,0,61
2020-11-07,PVT2,239,72,168,146,22,53,2,91
2020-11-07,MP1,377,85,292,253,39,139,9,105
2020-11-07,MP1m,53,5,48,45,3,31,3,11
2020-11-07,MP2,756,99,658,624,34,370,17,237
2020-11-07,MP3,703,111,592,561,31,240,10,311
2020-11-07,MP4,642,80,562,510,52,264,19,227
2020-11-07,MP5,559,33,527,403,124,273,43,87
2020-11-08,PVT,160,56,104,83,21,23,0,60
2020-11-08,PVT2,239,72,168,146,22,52,3,91
2020-11-08,MP1,377,85,292,253,39,137,10,106
2020-11-08,MP1m,53,5,48,45,3,32,2,11
2020-11-08,MP2,756,99,658,624,34,367,19,238
2020-11-08,MP3,703,111,592,561,31,238,7,316
2020-11-08,MP4,642,80,562,510,52,263,18,229
2020-11-08,MP5,559,33,527,407,120,274,42,91
2020-11-09,PVT,160,56,104,83,21,23,0,60
2020-11-09,PVT2,239,72,168,146,22,50,3,93
2020-11-09,MP1,377,85,292,253,39,135,10,108
2020-11-09,MP1m,53,5,48,45,3,30,1,14
2020-11-09,MP2,756,100,657,623,34,366,19,238
2020-11-09,MP3,703,111,592,561,31,238,6,317
2020-11-09,MP4,642,80,562,511,51,260,16,235
2020-11-09,MP5,567,33,535,411,124,277,47,87
2020-11-10,PVT,160,56,104,83,21,25,0,58
2020-11-10,PVT2,239,73,167,145,22,48,3,94
2020-11-10,MP1,377,88,289,250,39,135,7,108
2020-11-10,MP1m,53,5,48,45,3,31,0,14
2020-11-10,MP2,756,104,653,619,34,361,18,240
2020-11-10,MP3,703,114,589,558,31,231,12,315
2020-11-10,MP4,642,83,559,509,50,254,17,238
2020-11-10,MP5,571,42,530,407,123,279,49,79
2020-11-11,PVT,160,56,104,83,21,25,0,58
2020-11-11,PVT2,239,73,167,145,22,48,3,94
2020-11-11,MP1,377,89,288,249,39,136,8,105
2020-11-11,MP1m,53,5,48,45,3,31,0,14
2020-11-11,MP2,756,104,653,619,34,364,13,242
2020-11-11,MP3,703,114,589,558,31,232,13,313
2020-11-11,MP4,642,83,559,509,50,251,16,242
2020-11-11,MP5,589,43,547,408,139,284,47,77
2020-11-12,PVT,160,56,104,83,21,24,0,59
2020-11-12,PVT2,239,73,167,145,22,47,3,95
2020-11-12,MP1,377,89,288,249,39,136,9,104
2020-11-12,MP1m,53,5,48,45,3,31,0,14
2020-11-12,MP2,756,104,653,619,34,365,12,242
2020-11-12,MP3,703,114,589,558,31,234,11,313
2020-11-12,MP4,642,83,559,509,50,253,15,241
2020-11-12,MP5,598,43,556,412,144,287,46,79
2020-11-13,PVT,160,56,104,83,21,24,0,59
2020-11-13,PVT2,239,73,167,145,22,48,1,96
2020-11-13,MP1,377,89,288,249,39,138,8,103
2020-11-13,MP1m,53,5,48,45,3,31,0,14
2020-11-13,MP2,756,104,653,619,34,359,11,249
2020-11-13,MP3,703,114,589,558,31,234,11,313
2020-11-13,MP4,642,84,558,508,50,252,14,242
2020-11-13,MP5,615,43,573,415,158,283,53,79
2020-11-14,PVT,160,56,104,83,21,24,0,59
2020-11-14,PVT2,239,73,167,145,22,48,1,96
2020-11-14,MP1,377,89,288,249,39,139,6,104
2020-11-14,MP1m,53,5,48,45,3,31,0,14
2020-11-14,MP2,756,104,653,619,34,360,12,247
2020-11-14,MP3,703,114,589,558,31,233,12,313
2020-11-14,MP4,642,84,558,508,50,251,14,243
2020-11-14,MP5,615,43,573,422,151,287,47,88
2020-11-15,PVT,160,56,104,83,21,24,0,59
2020-11-15,PVT2,239,73,167,145,22,48,1,96
2020-11-15,MP1,377,89,288,249,39,139,7,103
2020-11-15,MP1m,53,5,48,45,3,31,0,14
2020-11-15,MP2,756,104,653,619,34,359,12,248
2020-11-15,MP3,703,114,589,558,31,231,14,313
2020-11-15,MP4,642,84,558,508,50,247,12,249
2020-11-15,MP5,615,43,573,429,144,293,46,90
2020-11-16,PVT,160,56,104,83,21,24,0,59
2020-11-16,PVT2,239,73,167,145,22,48,1,96
2020-11-16,MP1,377,89,288,249,39,139,8,102
2020-11-16,MP1m,53,5,48,45,3,31,0,14
2020-11-16,MP2,756,104,653,619,34,357,12,250
2020-11-16,MP3,703,115,588,557,31,231,11,315
2020-11-16,MP4,642,84,558,508,50,248,10,250
2020-11-16,MP5,671,43,629,431,198,293,54,84
2020-11-17,PVT,160,56,104,83,21,24,0,59
2020-11-17,PVT2,239,73,167,145,22,48,1,96
2020-11-17,MP1,377,90,287,248,39,138,9,101
2020-11-17,MP1m,53,5,48,45,3,32,0,13
2020-11-17,MP2,756,104,653,619,34,354,13,252
2020-11-17,MP3,703,115,588,557,31,228,13,316
2020-11-17,MP4,642,85,557,507,50,250,11,246
2020-11-17,MP5,697,44,654,440,214,293,59,88
2020-11-18,PVT,160,56,104,83,21,24,0,59
2020-11-18,PVT2,239,73,167,145,22,48,1,96
2020-11-18,MP1,377,90,287,248,39,137,7,104
2020-11-18,MP1m,53,5,48,45,3,32,0,13
2020-11-18,MP2,756,105,652,618,34,358,10,250
2020-11-18,MP3,703,115,588,557,31,226,8,323
2020-11-18,MP4,642,85,557,507,50,248,11,248
2020-11-18,MP5,698,46,653,447,206,291,64,92
2020-11-19,PVT,160,56,104,83,21,24,0,59
2020-11-19,PVT2,239,73,167,145,22,45,2,98
2020-11-19,MP1,377,90,287,248,39,137,6,105
2020-11-19,MP1m,53,5,48,45,3,32,0,13
2020-11-19,MP2,756,105,652,618,34,357,10,251
2020-11-19,MP3,703,116,587,556,31,222,11,323
2020-11-19,MP4,642,85,557,508,49,247,12,249
2020-11-19,MP5,699,46,654,456,198,291,72,93
2020-11-20,PVT,160,56,104,83,21,23,0,60
2020-11-20,PVT2,239,73,167,145,22,45,1,99
2020-11-20,MP1,377,90,287,248,39,133,8,107
2020-11-20,MP1m,53,5,48,45,3,31,0,14
2020-11-20,MP2,756,105,652,618,34,357,10,251
2020-11-20,MP3,703,116,587,556,31,223,9,324
2020-11-20,MP4,642,85,557,508,49,249,12,247
2020-11-20,MP5,699,46,654,466,188,299,67,100
2020-11-21,PVT,160,56,104,83,21,22,1,60
2020-11-21,PVT2,239,73,167,145,22,42,4,99
2020-11-21,MP1,377,90,287,248,39,134,6,108
2020-11-21,MP1m,53,5,48,45,3,31,0,14
2020-11-21,MP2,756,105,652,618,34,356,8,254
2020-11-21,MP3,703,116,587,556,31,222,10,324
2020-11-21,MP4,642,85,557,508,49,247,13,248
2020-11-21,MP5,699,46,654,487,167,304,69,114
2020-11-22,PVT,160,56,104,83,21,22,1,60
2020-11-22,PVT2,239,73,167,145,22,42,4,99
2020-11-22,MP1,377,90,287,248,39,135,3,110
2020-11-22,MP1m,53,5,48,45,3,31,0,14
2020-11-22,MP2,756,105,652,618,34,357,7,254
2020-11-22,MP3,703,116,587,556,31,219,10,327
2020-11-22,MP4,642,85,557,508,49,247,13,248
2020-11-22,MP5,699,46,654,493,161,310,79,104
2020-11-23,PVT,160,56,104,83,21,22,1,60
2020-11-23,PVT2,239,73,167,145,22,41,6,98
2020-11-23,MP1,377,91,286,247,39,133,3,111
2020-11-23,MP1m,53,6,47,44,3,29,0,15
2020-11-23,MP2,756,105,652,618,34,356,7,255
2020-11-23,MP3,703,116,587,556,31,219,8,329
2020-11-23,MP4,642,87,555,506,49,244,11,251
2020-11-23,MP5,804,47,758,503,255,314,81,108
2020-11-24,PVT,160,56,104,83,21,22,1,60
2020-11-24,PVT2,239,74,166,144,22,40,6,98
2020-11-24,MP1,377,91,286,247,39,134,2,111
2020-11-24,MP1m,53,6,47,44,3,28,0,16
2020-11-24,MP2,756,105,652,618,34,353,10,255
2020-11-24,MP3,703,116,587,556,31,215,7,334
2020-11-24,MP4,642,88,554,506,48,244,11,251
2020-11-24,MP5,820,47,774,507,267,319,84,104
2020-11-25,PVT,160,56,104,83,21,21,1,61
2020-11-25,PVT2,239,74,166,144,22,40,6,98
2020-11-25,MP1,377,91,286,247,39,134,2,111
2020-11-25,MP1m,53,6,47,44,3,28,0,16
2020-11-25,MP2,756,105,652,618,34,351,13,254
2020-11-25,MP3,703,116,587,556,31,216,8,332
2020-11-25,MP4,642,88,554,506,48,243,11,252
2020-11-25,MP5,829,47,783,508,275,331,74,103
2020-11-26,PVT,160,56,104,83,21,21,1,61
2020-11-26,PVT2,239,74,166,144,22,41,4,99
2020-11-26,MP1,377,91,286,247,39,135,2,110
2020-11-26,MP1m,53,6,47,44,3,28,0,16
2020-11-26,MP2,756,105,652,618,34,348,13,257
2020-11-26,MP3,703,116,587,556,31,219,5,332
2020-11-26,MP4,642,88,554,506,48,245,11,250
2020-11-26,MP5,829,47,783,511,272,337,71,103
2020-11-27,PVT,160,56,104,83,21,22,1,60
2020-11-27,PVT2,239,74,166,144,22,41,4,99
2020-11-27,MP1,377,91,286,247,39,131,2,114
2020-11-27,MP1m,53,6,47,44,3,28,0,16
2020-11-27,MP2,756,105,652,618,34,343,17,258
2020-11-27,MP3,703,116,587,556,31,218,5,333
2020-11-27,MP4,642,88,554,506,48,242,12,252
2020-11-27,MP5,836,47,790,515,275,352,56,107
2020-11-28,PVT,160,56,104,83,21,23,0,60
2020-11-28,PVT2,239,74,166,144,22,42,3,99
2020-11-28,MP1,377,91,286,247,39,129,2,116
2020-11-28,MP1m,53,6,47,45,2,28,1,16
2020-11-28,MP2,756,105,652,618,34,341,19,258
2020-11-28,MP3,703,116,587,556,31,218,5,333
2020-11-28,MP4,642,88,554,506,48,244,11,251
2020-11-28,MP5,836,47,790,526,264,358,54,114
2020-11-29,PVT,160,56,104,83,21,22,0,61
2020-11-29,PVT2,239,74,166,144,22,43,2,99
2020-11-29,MP1,377,91,286,247,39,127,3,117
2020-11-29,MP1m,53,6,47,45,2,27,3,15
2020-11-29,MP2,756,105,652,618,34,342,19,257
2020-11-29,MP3,703,116,587,556,31,217,4,335
2020-11-29,MP4,642,88,554,506,48,244,11,251
2020-11-29,MP5,861,48,814,540,274,371,51,118
2020-11-30,PVT,160,56,104,83,21,22,0,61
2020-11-30,PVT2,239,74,166,145,21,45,1,99
2020-11-30,MP1,377,91,286,247,39,124,4,119
2020-11-30,MP1m,53,6,47,45,2,27,3,15
2020-11-30,MP2,756,105,652,618,34,344,16,258
2020-11-30,MP3,703,116,587,556,31,214,4,338
2020-11-30,MP4,642,88,554,506,48,242,11,253
2020-11-30,MP5,868,48,821,549,272,371,62,116
2020-12-01,PVT,160,56,104,83,21,22,0,61
2020-12-01,PVT2,239,75,165,144,21,43,2,99
2020-12-01,MP1,377,91,286,247,39,124,5,118
2020-12-01,MP1m,53,6,47,45,2,27,3,15
2020-12-01,MP2,756,106,651,617,34,345,14,258
2020-12-01,MP3,703,116,587,556,31,215,4,337
2020-12-01,MP4,642,88,554,506,48,242,10,254
2020-12-01,MP5,936,50,887,555,332,373,70,112
2020-12-02,PVT,160,56,104,83,21,22,0,61
2020-12-02,PVT2,239,75,165,144,21,43,3,98
2020-12-02,MP1,377,91,286,247,39,122,4,121
2020-12-02,MP1m,53,6,47,45,2,28,3,14
2020-12-02,MP2,756,106,651,617,34,344,13,260
2020-12-02,MP3,703,116,587,556,31,212,4,340
2020-12-02,MP4,642,88,554,506,48,240,8,258
2020-12-02,MP5,938,50,889,568,321,374,73,121
2020-12-03,PVT,160,56,104,83,21,22,0,61
2020-12-03,PVT2,239,75,165,144,21,43,1,100
2020-12-03,MP1,377,91,286,247,39,121,4,122
2020-12-03,MP1m,53,6,47,45,2,28,3,14
2020-12-03,MP2,756,106,651,617,34,346,11,260
2020-12-03,MP3,703,116,587,556,31,211,4,341
2020-12-03,MP4,642,88,554,506,48,238,8,260
2020-12-03,MP5,984,50,935,578,357,378,82,118
2020-12-04,PVT,160,56,104,83,21,23,0,60
2020-12-04,PVT2,239,77,163,142,21,43,1,98
2020-12-04,MP1,377,100,277,238,39,121,5,112
2020-12-04,MP1m,53,6,47,45,2,30,1,14
2020-12-04,MP2,756,111,646,612,34,347,7,258
2020-12-04,MP3,703,120,583,552,31,210,3,339
2020-12-04,MP4,642,90,552,505,47,236,10,259
2020-12-04,MP5,1000,56,945,580,365,382,86,112
2020-12-05,PVT,160,56,104,83,21,23,0,60
2020-12-05,PVT2,239,77,163,142,21,43,1,98
2020-12-05,MP1,377,100,277,238,39,121,4,113
2020-12-05,MP1m,53,6,47,45,2,30,1,14
2020-12-05,MP2,756,111,646,613,33,345,9,259
2020-12-05,MP3,703,120,583,552,31,207,4,341
2020-12-05,MP4,642,90,552,505,47,236,9,260
2020-12-05,MP5,1022,56,967,584,383,392,80,112
2020-12-06,PVT,160,56,104,83,21,23,1,59
2020-12-06,PVT2,239,77,163,142,21,43,1,98
2020-12-06,MP1,377,100,277,238,39,121,4,113
2020-12-06,MP1m,53,6,47,45,2,31,0,14
2020-12-06,MP2,756,111,646,613,33,345,10,258
2020-12-06,MP3,703,120,583,552,31,208,3,341
2020-12-06,MP4,642,90,552,505,47,237,8,260
2020-12-06,MP5,1024,56,969,596,373,402,75,119
2020-12-07,PVT,160,56,104,83,21,22,1,60
2020-12-07,PVT2,239,77,163,142,21,44,0,98
2020-12-07,MP1,377,101,276,237,39,121,2,114
2020-12-07,MP1m,53,6,47,45,2,31,0,14
2020-12-07,MP2,756,113,644,611,33,342,8,261
2020-12-07,MP3,703,121,582,551,31,208,2,341
2020-12-07,MP4,642,90,552,505,47,237,8,260
2020-12-07,MP5,1103,66,1038,597,441,406,72,119
2020-12-08,PVT,160,56,104,83,21,22,1,60
2020-12-08,PVT2,239,78,162,141,21,43,0,98
2020-12-08,MP1,377,102,275,236,39,123,2,111
2020-12-08,MP1m,53,6,47,45,2,31,0,14
2020-12-08,MP2,756,113,644,611,33,343,8,260
2020-12-08,MP3,703,122,581,550,31,204,2,344
2020-12-08,MP4,642,90,552,505,47,235,9,261
2020-12-08,MP5,1135,72,1064,604,460,416,65,123
2020-12-09,PVT,160,56,104,83,21,22,1,60
2020-12-09,PVT2,239,79,161,140,21,42,0,98
2020-12-09,MP1,377,102,275,236,39,123,2,111
2020-12-09,MP1m,53,6,47,45,2,31,0,14
2020-12-09,MP2,756,114,643,610,33,340,10,260
2020-12-09,MP3,703,122,581,550,31,203,2,345
2020-12-09,MP4,642,91,551,504,47,233,10,261
2020-12-09,MP5,1153,73,1081,611,470,426,65,120
2020-12-10,PVT,160,56,104,83,21,21,1,61
2020-12-10,PVT2,239,79,161,140,21,41,0,99
2020-12-10,MP1,377,102,275,236,39,124,1,111
2020-12-10,MP1m,53,6,47,45,2,31,0,14
2020-12-10,MP2,756,114,643,610,33,340,10,260
2020-12-10,MP3,703,122,581,550,31,201,4,345
2020-12-10,MP4,642,91,551,504,47,238,5,261
2020-12-10,MP5,1187,73,1115,619,496,431,68,120
2020-12-11,PVT,160,56,104,83,21,21,1,61
2020-12-11,PVT2,239,79,161,140,21,41,0,99
2020-12-11,MP1,377,103,274,235,39,124,2,109
2020-12-11,MP1m,53,6,47,45,2,30,0,15
2020-12-11,MP2,756,114,643,611,32,341,11,259
2020-12-11,MP3,703,122,581,550,31,202,3,345
2020-12-11,MP4,642,93,549,502,47,237,6,259
2020-12-11,MP5,1195,75,1121,625,496,436,74,115
2020-12-12,PVT,160,56,104,83,21,20,2,61
2020-12-12,PVT2,239,79,161,140,21,41,0,99
2020-12-12,MP1,377,103,274,235,39,123,2,110
2020-12-12,MP1m,53,6,47,45,2,30,0,15
2020-12-12,MP2,756,114,643,611,32,339,10,262
2020-12-12,MP3,703,122,581,550,31,204,3,343
2020-12-12,MP4,642,93,549,502,47,237,5,260
2020-12-12,MP5,1195,75,1121,634,487,446,71,117
2020-12-13,PVT,160,56,104,83,21,19,2,62
2020-12-13,PVT2,239,79,161,140,21,40,1,99
2020-12-13,MP1,377,103,274,235,39,123,2,110
2020-12-13,MP1m,53,6,47,45,2,30,0,15
2020-12-13,MP2,756,114,643,611,32,342,9,260
2020-12-13,MP3,703,122,581,550,31,205,3,342
2020-12-13,MP4,642,93,549,502,47,234,8,260
2020-12-13,MP5,1195,75,1121,643,478,447,74,122
2020-12-14,PVT,160,56,104,83,21,20,2,61
2020-12-14,PVT2,239,79,161,140,21,41,1,98
2020-12-14,MP1,377,105,272,233,39,123,0,110
2020-12-14,MP1m,53,6,47,45,2,30,0,15
2020-12-14,MP2,756,114,643,611,32,341,11,259
2020-12-14,MP3,703,122,581,550,31,204,4,342
2020-12-14,MP4,642,93,549,502,47,233,6,263
2020-12-14,MP5,1195,81,1115,644,471,452,73,119
2020-12-15,PVT,160,56,104,83,21,20,2,61
2020-12-15,PVT2,239,79,161,140,21,41,1,98
2020-12-15,MP1,377,105,272,233,39,122,1,110
2020-12-15,MP1m,53,6,47,45,2,30,0,15
2020-12-15,MP2,756,114,643,611,32,340,10,261
2020-12-15,MP3,703,122,581,550,31,205,4,341
2020-12-15,MP4,642,93,549,502,47,233,7,262
2020-12-15,MP5,1195,81,1115,653,462,462,66,125
2020-12-16,PVT,160,56,104,83,21,19,2,62
2020-12-16,PVT2,239,79,161,140,21,40,1,99
2020-12-16,MP1,377,105,272,233,39,122,1,110
2020-12-16,MP1m,53,6,47,45,2,30,0,15
2020-12-16,MP2,756,114,643,611,32,342,10,259
2020-12-16,MP3,703,122,581,550,31,206,3,341
2020-12-16,MP4,642,93,549,502,47,234,5,263
2020-12-16,MP5,1195,81,1115,664,451,467,71,126
2020-12-17,PVT,160,56,104,83,21,19,1,63
2020-12-17,PVT2,239,79,161,140,21,39,1,100
2020-12-17,MP1,377,105,272,233,39,122,1,110
2020-12-17,MP1m,53,6,47,45,2,29,0,16
2020-12-17,MP2,756,114,643,611,32,344,8,259
2020-12-17,MP3,703,122,581,550,31,202,2,346
2020-12-17,MP4,642,93,549,502,47,232,5,265
2020-12-17,MP5,1195,81,1115,669,446,474,74,121
2020-12-18,PVT,160,56,104,83,21,19,1,63
2020-12-18,PVT2,239,79,161,140,21,39,1,100
2020-12-18,MP1,377,105,272,233,39,120,2,111
2020-12-18,MP1m,53,6,47,45,2,29,0,16
2020-12-18,MP2,756,114,643,611,32,342,8,261
2020-12-18,MP3,703,122,581,550,31,201,2,347
2020-12-18,MP4,642,93,549,502,47,231,6,265
2020-12-18,MP5,1195,81,1115,674,441,475,77,122